NO ./textures/wall_bonus.xpm
WE ./textures/wall_4.xpm
SO ./textures/wall_2.xpm
EA ./textures/apple.xpm

F 12,34,23
C 74, 34,39

 111111111111111111111
 11111111000000000001
1000000000000S00000111
 11111111111111111111
  11111111111111111111